?SIZE 20 18
EEE#EEEEE#GG#EEEEE#E
##########GG########
#LSSSSSSSSSSSSSSSSL#
#LSSBBBBSSSSBBBBSSL#
#LSSBBBBSSSSBBBBSSL#
#LSSBDBBSSSSBDBBSSL#
#LSSSSSSSSSSSSSSSSL#
#LSSSSSSSSSSSSSSSSL#
#LSSSSSSSSBBBBBBSSL#
#LSSJJJJSSBBBBBBSSL#
#LSSLLLLSSBBBBBBSSL#
#LSSLLLLSSBBDDBBSSL#
#LSSSSSSSSSSSSSSSSL#
#LSSSSSSSSJJJJJJSSL#
#LLLWWWWSSLLLLLLSSL#
#LLLWWWWSSLLLLLLSSL#
#LLLWWWWSSSSSSSSSSL#
##LLWWWW############